{
	"maze":
	[
		"####################",
		"#o    #####       x#",
		"##### ##### ## #####",
		"##### #   # ## #####",
		"##### ### # ## #####",
		"##### ### # ##   ###",
		"##### ### # ## #####",
		"##### ### # ## #####",
		"#           ## #####",
		"####################"
	],

	"assets":
	[
		{ "id": "background", "name": "background.png" },

		{ "id": "runner", "name": "runner.png" },
		{ "id": "goal", "name": "goal.png" },
		{ "id": "trap", "name": "trap.png" }
	]
}